35 20
~~~~~~~~~~~~~~~~~#~~~~~~~~~~~~~~~~~
~######~########~#~########~######~
~#~~~~~~~~~~~~~~~~~~~~~~~~~~~~~~~#~
~#~#########~###~#~###~#########~#~
~~~~~~~~~~~~~~~~~#~~~~~~~~~~~~~~~~~
~#~#####~#######~~~#######~#####~#~
~#~~~~~~~~~~~~~~~#~~~~~~~~~~~~~~~#~
~#~########~#~#######~#~########~#~
~~~~~~~~~~~~#~~~~~~~~~#~~~~~~~~~~~~
###~##~####~#~###~###~#~####~##~###
###~##~~~~~~#~~~~~~~~~#~~~~~~##~###
~~~~~~~####~#~#######~#~####~~~~~~~
~##~#####~~~~~~~~~~~~~~~~~#####~##~
~##~~~~~~~#######~#######~~~~~~~##~
~####~###~~~~~###~###~~~~~###~####~
~####~###~###~~~~~~~~~###~###~####~
~~~~~~~~~~###~#######~###~~~~~~~~~~
~######~#~~~~~~~~#~~~~~~~~#~######~
~######~########~#~########~######~
~~~~~~~~~~~~~~~~~#~~~~~~~~~~~~~~~~~